11111111
10000001
11000001
10010101
10010101
10000001
11111111
