1111111111
1P00000001
1101000001
1001010001
1100000101
1E00010001
100C000C01
1111111111
