1111111111
1P0C00C001
1101000001
1001010001
1100000101
1E00C10001
1000000001
1111111111
