11111111
1P0C0001
11000001
1001E101
10010101
1000C0C1
11111111
